en-US-Chirp3-HD-Achernar	FEMALE
en-US-Chirp3-HD-Achird	MALE
en-US-Chirp3-HD-Algenib	MALE
en-US-Chirp3-HD-Algieba	MALE
en-US-Chirp3-HD-Alnilam	MALE
en-US-Chirp3-HD-Aoede	FEMALE
en-US-Chirp3-HD-Autonoe	FEMALE
en-US-Chirp3-HD-Callirrhoe	FEMALE
en-US-Chirp3-HD-Charon	MALE
en-US-Chirp3-HD-Despina	FEMALE
en-US-Chirp3-HD-Enceladus	MALE
en-US-Chirp3-HD-Erinome	FEMALE
en-US-Chirp3-HD-Fenrir	MALE
en-US-Chirp3-HD-Gacrux	FEMALE
en-US-Chirp3-HD-Iapetus	MALE
en-US-Chirp3-HD-Kore	FEMALE
en-US-Chirp3-HD-Laomedeia	FEMALE
en-US-Chirp3-HD-Leda	FEMALE
en-US-Chirp3-HD-Orus	MALE
en-US-Chirp3-HD-Puck	MALE
en-US-Chirp3-HD-Pulcherrima	FEMALE
en-US-Chirp3-HD-Rasalgethi	MALE
en-US-Chirp3-HD-Sadachbia	MALE
en-US-Chirp3-HD-Sadaltager	MALE
en-US-Chirp3-HD-Schedar	MALE
en-US-Chirp3-HD-Sulafat	FEMALE
en-US-Chirp3-HD-Umbriel	MALE
en-US-Chirp3-HD-Vindemiatrix	FEMALE
en-US-Chirp3-HD-Zephyr	FEMALE
en-US-Chirp3-HD-Zubenelgenubi	MALE
