CwhRBWXzGAHq8TQ4Fs17	Roger - Laid-Back, Casual, Resonant	premade
EXAVITQu4vr4xnSDxMaL	Sarah - Mature, Reassuring, Confident	premade
FGY2WhTYpPnrIDTdsKH5	Laura - Enthusiast, Quirky Attitude	premade
IKne3meq5aSn9XLyUdCD	Charlie - Deep, Confident, Energetic	premade
JBFqnCBsd6RMkjVDRZzb	George - Warm, Captivating Storyteller	premade
N2lVS1w4EtoT3dr4eOWO	Callum - Husky Trickster	premade
SAz9YHcvj6GT2YYXdXww	River - Relaxed, Neutral, Informative	premade
SOYHLrjzK2X1ezoPC6cr	Harry - Fierce Warrior	premade
TX3LPaxmHKxFdv7VOQHJ	Liam - Energetic, Social Media Creator	premade
Xb7hH8MSUJpSbSDYk0k2	Alice - Clear, Engaging Educator	premade
XrExE9yKIg1WjnnlVkGX	Matilda - Knowledgable, Professional	premade
bIHbv24MWmeRgasZH58o	Will - Relaxed Optimist	premade
cgSgspJ2msm6clMCkdW9	Jessica - Playful, Bright, Warm	premade
cjVigY5qzO86Huf0OWal	Eric - Smooth, Trustworthy	premade
hpp4J3VqNfWAUOO0d1Us	Bella - Professional, Bright, Warm	premade
iP95p4xoKVk53GoZ742B	Chris - Charming, Down-to-Earth	premade
nPczCjzI2devNBz1zQrb	Brian - Deep, Resonant and Comforting	premade
onwK4e9ZLuTAKqWW03F9	Daniel - Steady Broadcaster	premade
pFZP5JQG7iQjIQuC4Bku	Lily - Velvety Actress	premade
pNInz6obpgDQGcFmaJgB	Adam - Dominant, Firm	premade
pqHfZKP75CvOlQylNhV4	Bill - Wise, Mature, Balanced	premade
AW5wrnG1jVizOYY7R1Oo	JiYoung	professional
3MTvEr8xCMCC2mL9ujrI	June	professional
uyVNoMrnUku1dZyVEXwD	Anna Kim	professional
sf8Bpb1IU97NI9BHSMRf	Rumi Oh	professional
ETPP7D0aZVdEj12Aa7ho	Selly Han	professional
1W00IGEmNmwmsDeYy7ag	KKC - Korean Bright Voice	professional
0oqpliV6dVSr9XomngOW	Jini - Warm & Intelligent Korean Female	professional
DMkRitQrfpiddSQT5adl	jjeong	professional
zgDzx5jLLCqEp6Fl7Kl7	Hanna - Natural Korean Female Voice	professional
